
NO 220,120,100
SO 225,130,110
WE 230,140,120
EA 235,150,130

F 220,100,0
C 225,30,0

1111111111111111111111111
1000000000000000010000001
1000111111111000010001001
1000000000001000000001001
1000111110001111110000001
1000000010000000000001001
1000000011110111110001001
100010N000000000011111001
1000100000000000000000001
1000111111111111110000001
1000000000000000000000001
1111111111111111111111111
